3
10 10
# # # # # # # # # #
# @ . . . . . . . #
# . # # . # # # . #
# . # . . . # $ . #
# . # & ^ * # . . #
# . . # # # . . # #
# # . . . . . . . #
# . . # # # # # # #
# . . . . . . . ! #
# # # # # # # # # #
10 21
# # # # # # # # # # # # # # # # # # # # #
# @ . # . . . . . # # . . . # . . # # ! #
# . # # . # # # . . # . # . . # . . # . #
# . # . . . # * # . # . # . . . . . . . #
# . . . . . # . . . # . # . # . . # . . #
# . . # # # . . # . # . # . . # . . # # #
# # . . . . . . . . # . # # . . # . . . #
# . . . # # # # # # # . # # # & # # . . #
# . . . . . $ . . . . . # . . . . . . ^ #
# # # # # # # # # # # # # # # # # # # # #
20 30
# # # # # # # # # # # # # # # # # # # # # # # # # # # # # #
# @ . . . . . . . # # . . . # . . # # . # . . . # . . . # #
# . # # . # # # . . . . # . . # . . # . # . # # # . # . # #
# . # . . # . . # . # . # . . # . . . . # . # . . . # . # #
# . # . . # . . . . # . # . # * . # . . # . # . # . # . . #
# . . # # # . . # . # . # . . # . . # # # . # . # . # # ! # 
# # . . . . . . . . . . # . . . # . . * # . . . # . # # . #
# . . # # # . # # # # . # # # . # # . . # . # # # . # # . #
# . . # . . . . . . . . # . . . . . # . . . . . # . . . . # 
# . . . . . . # . . . . . . . # . . . . . # . . # . . . . #
# # # . # # # # # . # # # # # # . . . # # # # # # # # # # #
# . . . . . . . . . # . . . # . . # . . # . . . # . . . # #
# . # # . # # # . . . . # . . # . # . . # . # # # . # . . #
# . # . . # . . # . # . # . . # . # . . . . # . . . # . # #
# . # . . # . . . . . . . . # . . # . . # . # . # . # . # #
# . . # # # . . # . # . # . . # . . # # # . # . # . # . . # 
# # # # . . . . . . . . # . . . . . # $ # . . . # . . . . #
# . . . # # . # # # # . # # # . # # . . # # # # # . # # . #
# . . . . . . & . . . . # . . . . . . . . ^ . . . . . . . # 
# # # # # # # # # # # # # # # # # # # # # # # # # # # # # #


